{
    "groundTextureUrl": "./textures/ground.jpg",
    "wallTextureUrl": "./textures/wall.jpg",
    "size": { "width": 10, "height": 10 },
    "map": [
        [3, 2, 2, 2, 3, 2, 3, 2, 2, 2, 1],
        [1, 0, 0, 0, 1, 0, 1, 0, 0, 0, 1],
        [1, 0, 4, 5, 1, 0, 1, 0, 4, 0, 1],
        [1, 0, 0, 0, 1, 0, 1, 0, 0, 0, 1],
        [3, 2, 2, 6, 0, 0, 2, 6, 2, 2, 1],
        [1, 7, 7, 0, 0, 0, 0, 0, 0, 7, 1],
        [3, 2, 2, 6, 1, 0, 3, 6, 2, 2, 1],
        [1, 0, 0, 0, 1, 0, 1, 0, 0, 0, 1], 
        [1, 0, 4, 0, 1, 0, 1, 0, 4, 0, 1],
        [1, 0, 0, 0, 1, 0, 1, 0, 0, 0, 1],
        [2, 2, 2, 2, 2, 2, 2, 2, 2, 2, 0] 
    ], 
    "initialPosition": [2, 2],
    "initialDirection": 0.0,
    "exitLocation": [-0.5, 6]
}






